12 8 9 9 9 9 9 9 9 9 9 9 9 9 24 13
14 10 20 20 20 1 1 1 1 1 1 20 1 1 11 15
14 16 1 20 1 1 20 1 1 1 1 20 1 1 17 15
12 18 1 1 20 1 1 20 1 1 1 1 20 1 19 13
12 23 1 1 1 20 1 20 20 20 20 1 1 1 22 13
12 23 1 1 20 1 1 1 1 1 1 1 1 1 22 13
12 23 1 1 1 1 20 1 20 1 1 20 20 1 22 13
12 23 1 1 20 1 1 1 1 1 1 1 1 1 22 13
14 10 20 1 1 1 20 1 1 1 1 1 1 1 11 15
14 16 1 1 20 1 20 1 1 1 1 1 1 1 17 15
12 18 20 1 1 1 20 1 1 1 1 1 1 1 19 13
2 6 7 7 7 7 7 7 7 7 7 7 7 7 21 3