12 2 3 3 3 3 3 3 3 3 3 3 3 3 4 5
6 7 8 8 8 8 8 8 8 8 8 8 8 8 9 10
12 11 1 15 1 15 1 15 1 15 1 15 1 1 13 5
6 7 1 1 15 15 15 1 15 1 1 15 15 15 9 10
12 11 1 15 1 15 1 15 1 15 1 15 15 1 13 5
6 7 1 1 1 15 1 1 15 1 15 1 1 15 9 10
12 11 1 15 1 15 1 15 1 15 1 15 1 15 13 5
6 7 15 1 1 15 1 1 1 15 1 1 1 1 9 10
12 11 1 15 1 15 1 15 1 15 1 15 1 1 13 5
6 7 15 1 1 15 1 1 15 1 1 1 1 15 9 10
12 11 1 1 1 1 1 1 1 1 14 1 1 1 13 5
6 16 17 16 17 16 17 16 17 16 17 16 17 16 17 5