1 2 3 3 3 3 3 3 3 3 3 3 3 3 4 5
6 7 8 8 8 8 8 8 8 8 8 8 8 8 9 10
11 7 8 25 8 25 8 25 8 25 8 25 8 25 9 12
13 7 25 8 25 8 25 8 25 8 25 8 25 8 9 18
15 7 8 8 8 8 8 8 8 8 8 8 8 8 9 12
16 7 8 8 8 8 8 8 8 8 8 8 8 8 9 20
17 7 8 8 8 8 8 8 8 8 8 8 8 8 9 21
6 7 25 8 8 8 8 8 8 8 8 8 25 8 9 5
11 7 8 8 8 8 8 25 8 25 8 25 8 25 9 5
28 7 25 8 25 8 25 8 25 8 25 8 25 8 9 22
17 7 8 8 8 8 8 26 8 8 8 8 8 8 9 1
1 23 3 3 3 3 3 3 3 3 3 3 3 3 24 1