1 2 3 3 3 4 5 6 7 8 9 3 3 3 10 11
12 13 14 14 14 14 14 14 14 14 14 14 14 14 15 16
17 18 14 22 22 22 14 14 14 14 14 14 14 14 19 11
17 18 14 22 22 22 14 14 14 14 14 14 14 14 19 11
12 13 14 14 14 14 22 22 22 14 22 22 22 22 15 16
17 18 14 22 14 14 22 14 22 14 22 14 14 14 19 11
12 13 22 14 22 14 14 14 14 14 14 14 14 14 15 16
17 18 14 22 14 14 22 14 22 14 14 14 14 14 19 11
12 13 22 14 22 14 22 14 14 22 14 22 22 22 15 16
17 18 14 22 14 14 22 22 22 14 22 14 14 22 19 11
12 13 22 22 22 14 14 14 14 14 14 14 14 14 15 16
17 18 14 14 14 14 14 14 14 14 14 14 14 23 19 11
20 21 20 21 20 21 20 21 20 21 20 21 20 21 20 21