1 2 3 3 3 3 3 3 3 3 3 3 3 3 4 4
5 5 6 6 6 6 6 6 6 6 6 6 6 6 7 7
8 9 10 10 10 10 10 10 10 10 10 10 10 10 11 12
5 5 17 17 17 10 17 10 17 10 17 10 17 10 7 7
8 9 10 10 10 10 10 10 10 10 10 10 10 10 11 12
5 5 17 10 17 17 17 10 17 10 17 10 17 10 7 7 
8 9 10 10 10 10 10 10 10 10 10 10 10 10 11 12
5 5 17 10 17 10 17 10 17 10 17 10 17 10 7 7
8 9 10 10 10 10 10 10 10 10 10 10 10 10 11 12
5 5 17 10 17 10 17 10 17 10 17 10 17 10 7 7
8 9 10 10 10 10 10 10 10 10 10 10 10 10 11 12
13 14 3 3 3 3 3 3 3 3 3 3 3 3 15 16